@@@@@@@@@@@@@@@@@@@@@@@@@@@@@@@@@@@@@@@@@@@@@@@@@@@@@@@@@@@@@@@@@@@@@@@@@@@@@@@@@@@@@@@@@@@@@@@@@@@@@@@@@@@@@@@@@@@@@@@@@@@@@@@@@@@@@@@@@@@@@@@@@@@@@@@@@@@@@@@@
@.e@@@@@...@...@..@@@@@@@@@@@...@@...@@@@@@@@@@.@@@@.......@@@@@@....@@...@@@@@..@@@.......@@...@@@@@@@.......@.....@@@..@@.@..@@@@@@..@@.@.....@@@@@..@@@....@@
@..@.@@@...@...@..@@@@@@@@@@@...@....@@@@@@@@@..@@@@........@@@@.....@@...@@@@@@.@@........@@...@@@@@@@.................@@@.....@@@@@@.@.........@@@@@.@@@.....@
@..@@@@@@@@@@@.@@.@@@@@@@@@@@@.....e@@@@@@@@@@..@@@@.@@@.....@@@.@@@..@@..@@@@@@@..@@@@@@@..@@..@@@@@@@...@@.........@@@@@@@..@@@@@@@@@..@@@.@@..@@@@@..@@@....@
@......@@@@@@@@..@@@@@@@@@@@@@@@@@@.@@@@@@@@....@@@..@@@@.....@..@@@@..@@.@@@@@@@@@@@@@@@@@@.....@@@@@@..@@@@....@..@@@@@@@...@@@@@@@@@@@@@.@@@@.@@@@@..@@@@...@
@m.@@......@@@@@@@@@@@@@@@...@@@@@@..@@@..@......@...@@@@@.......@@@.......@@@@@@@@@@@..@@@@@....@@@@.....@@.....@..@@@@@......@@@@@@@@@@@..@@@@.@@@@@...@@.@@@@
@@@@@@.....@@@@@@@@@@@@@@.@...@@@@@.........@........@@@@@@.....@@@........@.@@@@@@@@@@.@@@@@@@@@@@...@.........@@..@@@..@@@@..@@@...@@@@@.@@@@..@@@........@@@@
@@@@@@@m....@@@@@@.@@@@@@.@@@..@@....@@@@@@@@@@.....@@@@@@@......@@.....@@.@@.@@@@@@@@..@@@@@@@@@@...@@@.......@@...@@..@@@@@@..@@.@.@@@@@.@@@..@@@..@..@@..@@@@
@@@@@@@@@@@.........@@@@@..@@@...@@..@@@@@@@@@@....@@@@@@@@........@@@..@@..@@@@@@........@@@@@@@@.@@@@@@@@@@@@@@..@@...@@@@@@...@...@@@@@.@@@..@@..@@.@@@.@@@@@
@..@@@@@@@@....@....@@@@@..@@@...@@@.@@@@@@@@@@...@@@@@@@@..@@@@...@@@..@@@@@@@@........@..@@@@@...@@@@@@@@@@@@..@@@@..@@@@@@@@.....@@@@@@..@@.@@@.@@.@@@..@@@@@
@.....@@@@....@@.....@@@@.@@@....@@@@@@@@@@@@@@...@@@@@@@..@@@@@..@@@..@@@@@@@@...@@....@@....@@...@@@@@@@@.....@@@@..@@@@@@@@@.....@@@@@@..@@.@@@.@..@@@...@@@@
@.............@@@...............@@@..@@@@@@@@@@...@@@@@@..@@@@@@@..@@..@@@@@@@@...@@@....@@....@...@@@@@@@...@@@@@@@@@@....@@@@....@@@@@@@@.@..@@..@..@@@@@@@@@@
@............@@@@...@@.@@@...........@@@@@@@@@@...@@@....@@@@@@@@....@@@@@@@@@@...@@........@@.@...@@@@@....@@@@@@@@@.......@@@@.....@@@@@@@...@@..@..@@@@@@@@@@
@.....@.....@@@@@....@.@@@..........@@@@@@@@@@@........@@@@@@@@@@..@@@@...@@@.@@..@@...@@...@@@@....@@......@@@@@@@@.@@@@...@@@.....@@@@@@@@@@.@...@..@@@@.@@@@@
@@@...@@..@@@@@@@.....@@@@..@@......@@@...@@@........@@@@@@@@@@@@..@@@@.@......@@..@@.@@@@@@@@@@@...@...............@@@@@...@@.....@@@@@@@@@@@......@..@@@..@..@
@.....@@@............@@@@@.@@....@@@....@@.....@....@@@@@@@@@@@@.@.@@@@@@...@@.@@..@@..@@@@@@@@@...@......@@@@....@.@@@....@@......@@@@..@@@@@@.@...@@....@@@.@@
@.....@@@@.....@...@@@@@@@@....@.@@@.@..@@@...@@@@...@@@@@@@@@@@@.@@@@@@@@..@@.....@@..@@@@@@@@@...@....@@@@@@@@@...@@..@@@@@......@@@@.@.@@@@@.@....@@.......@@
@.....@@@@@..@@@@.@@@@@@@@@.@@@@.....@@..@@@@@@@@@@@..@@@@@@@@@@@@@@@@@@@@@.@@.....@@..@@@@.@......@.....@@@@@@@..@@@..@@@@@@.....@@@@..@.@@@@@......@@.@@.....@
@.......@@@@@@@@@@@@@@@@@@@@@@@@@@@.@@@@..@@@@@...@@..@@@@@@@@@@@@@@@@@@@@@..@@....@@..@@@..........@....@@@@@@..@@@@@....@@@...@@@@@@..@.@@@@@....@....@@@....@
@..@@@@..@@@@@@@@@@@@@@@@@@@@@@@@@@@@@@@@..@@......@@......@@@@@@@@@@@@@@@@....@@......@@..@....@...@.@...@@....@@@@@@........@@@@@@@@....@@@@@@@@@@....@@@.@@@@
@@@@@@@@@@@@@@.@@@@@@@@@@@@@@@@@@@@..@@@@@..........@@.....@@@@......@@@@@@...@@@@..............@.....@...@.....@@@@@@........@@@@@@@@...@@@@@@@@@@@....@@@.@@@@
@@@@@@...@@@@@...@@@@@@@@@@@@@@.......@@@@.............@@..@@@..@.....@@@@@@@@@@@@.....@.................@........@@@.........@@@@@@@@@.@@@@@@@@@@@..@@..@@@...@
@@@@@....@@@@.@..@@@@@@@@@@@@@@.@@@............@@@......@@.....@@@@@@..@@@@@@@@@......@@..@@.......@@@..@@...@........@....@..@@@@@@@@@@@@@@@@@@@@..@@@@..@@@..@
@@@@.....@@@..@..@@@@@@@...@@@@.@@@@.....@@......@@......@@...@@@@@@@..@@@@@@@@..@@..@@..@@@.......@@@..@@..@@.@@@....@...@@......@@@@@@@@@@@@@@@..@@@@@@..@@@@@
@@@......@@@..@@...@@@@@...@@@....@@@...@@@.......@@@.......@@@@@@@....@@@@@@@..@@@@@@..@@@@........@@@.@@.@@@........@....@.....@.@@@...@...@@@.@@@@@@@@@..@@@@
@@@...@..@@@@.@@@@..@@@@.....@@....@@@@@@@@........@@...@@...@@@@@..@@...@@@@@.@@@@@@@...@@.........@@@....@@@@@@@@...@...@@@....@...............@@@@@@@@@@.@@@@
@@@..@@.@@@@@.@@@@@@.@...@@..@@@@@..@@@@@@....@@....@..@@@@@..@@@..@@@.@..@@@@..@@@@@@@..@@...@@....@@@@@@@@@@@@@@@...@@@.@@@@.......@@@@@@@@...@@@@@@@@@@@.@@@@
@@@.@@@@@@@@@...@.......@@@@..@@@@...@@@@@...@@@....@@..@@@@@..@..@@@@.@@.@@.....@@@@@@..@..@@@@...@@@@@@@@@@@@@.....@@@@@@@@@..@@..@@@@@@@@....@@@@@@@@@@..@@@@
@...@@@@...@@@@.........@@@@...@@@.....@@@...@@.....@@@..@@@@@.@..@@@.............@@....@@.....@...@@@@@@@@@@@......@@@@@@......@@..@@@@@@....@...@@@@@@@..@@@@@
@..@@@......@@@@@@@....@@@@@@...........@@.........@@@@@..@@@@.@.@@@@........@@.........@@@.....@..@@@@@@@@@@...@@@@@@@@@.......@@..@@@@@....@@@@..@@@....@@@@@@
@@@@@@.......@@@@@@@@..@@@@@@...@@@..............@@@@@@@@..@@@....@@@.......@@@.........@@@.....@.@@@@@........@@....@@@@.......@@...@@@@...@@@@@@@......@@@@@@@
@@@@@@@........@@@@@@..@@@@@@....@@@..@...@.....@@@@@@@@@@..@.....@@@.@.....@@@@............@....@@@.........@@@......@@@...@...@@...@@@@......@@@@@@@@@@@@@@@@@
@@@@@@@.....@......@@@.@@@@@@.....@@@.@@..@@...@@@...@@@@@@....@@.@@@.@@.....@@@@..@@@@@....@@..@@@..@...@@@@@@@.......@@........@...@@@@....@...@@@@@@@@@@@@@@@
@@@@@@@.@...@@@@...@@@..@@@@@......@@..@@.@@@@@@@.....@@@@@....@@..@@@.@@@@...@@@@@@@@@@@...@@.@@@@.@@...@@@@@@....@....@......@.....@@@@....@@......@@@@@@@@@@@
@..@@@@@@...@@@@@@.@@@...@@@@@..@...@..@@@..@@@@.......@@@@....@@@.@@@@.......@@@@@@@@@@@...@@.@@@..@....@@@@@@....@@....@..........@@@@@@......@@@...@@@@@@@@@@
@..@@@@@@...@@@@@..@@@....@@@@@.@@..@..@@....@@........@@@@........@@@@@......@@@@@@@@@@@...@..@@@.@@......@@@@@....@@...@@.@.......@@@@@@@..@@...@@@@......@@@@
@.@@@@@@@..@@@@@..@@@@@@........@@@@..@@@@.............@@@@@@...@.....@@.....@@@@@@@@..@@.....@@@..@...@......@@.........@@@@........@@@....@@@@@.........@....@
@..@@@@@...@.....@@@@@@@@@@@....@@@@@@@@@@@@.....@....@@@@@@@@.@@@@....@@.@@@@@@@@@@....@....@@@@.@@.....................@@@.........@@......@@@@@@@.....@@@...@
@..@@@@@.......@@@@@@@@@@@@@@...@@@@@@@@@@@@@@@..@...@@@@@@@@@.@@@@..@....@@@@@..@@@....@.....@@..@.......@@@@@...@.@.....@@.....@@...........@@@@@@@...@@@@@..@
@........@@@...@@@@@@@@@@@@@@.@...@@@@@@@@@@@@@@.@...@@@@@@@@..@@@@..@.@@...@@....@@@......@..@...@...@..@@@@@@...@@@.....@..@@@...........@@@...@@@@@@@@@@@@@@@
@@@@.....@@@...@@@@......@@@.@@......@@@@@@@@@@@....@@@@@@@@...@@@@....@@@.........@@....@@@..@.......@..@@@@@@........@..@..@@@...@@....@@@@@@...@@@@.@@@@@@@@@
@@@@@....@@..@..@@..@@@@@....@@@..@@..@@@@@@@@@....@@@...@@@...@@@@....@@@@.@..@@..@@...@@@@..@...@...@..@@@..........@@...@.@@...@@@...@@@@@@@@@@.@@@.........@
@@....@@....@@@.@@..@@@@@....@@@@..@...@@@@@@.....@@@.....@@@....@..@..@@@@@.......@@..@@@@..@@...@......@...@@@.....@@@..@......@@@@@@@..@@@@@@@..@@@@........@
@..........@@@..@@..@@@@@....@@.....@......@@..@@@@@...@...@@@......@..@@@@@......@@@..@@@@.@@@@..@..@...@..@@@@@@@@@@...@@.....@@@@@@@@...@@@@@@.@@@@@@.@@@@@@@
@@@@@......@@...@@@..@@.............@@......@@.@@@@....@.....@@@.......@@@@..@@..@@@..@@@@@.@@@@.@@..@.....@@@@@@@@@@..........@@@@@@@@@....@@@@..@@@@@@@.@@@@@@
@@@@@......@@...@@...@.....@.........@@@@@..@@@.@@................@@..@@@@@..@@@@@@@.@@@@@@.@@@..@@..@@.....@@@@@@@@..@@@...@..@@@@@@@@...........@@@.......@@@@
@@@@@.@..............@@...@@......@...@@@@@.@@@.......@@@@....@@@@@@@@@@@@..@@@@@@..@@@@@@@.....@@@..@@@.....@@@@@@@..@@@..@@.@@@@@@@..@@@........@@@@@...@.@@@@
@@@@@.@@........@@..@@@@..@@...@@.....@@@@@..@@@..@@..@@@@@@.@@@@@@@@@@@@@.@@@@@@...@@@@@@@...@@@@@@..@@@.....@@@@@@..@@@@@@..@@@@........@@....@@.@@@....@.@.@@
@..@...@@.....@@@@@..@@@..@@...@........@@@..@@...@...@@@@..@@@@@@@@@@@@@@.@@@@@@..@@@@@@@@@..@@@@@@...@@@@....@@@@@@..@.....@@@@..@@......@@..@@@.@@@......@@@@
@......@@@@@@@@@@@@...@@@.@@.............@@@..........@@@..@@@@...@@@@@@@@@...@@...@@@@@@@.@@@@@@@@....@@@@.@...@@@@@@.......@@@.@@@........@@@@........@..@@@@@
@..@...@@@@@@@@@......@@@..........@@.....@@....@@....@@..@@@@@@.@@@@..@@@@@......@@@@@@@...@@@@@@@...@@@..@@@..@@@@@@@@.....@@@.@.....@@...@@@...@...@@@.@@@@@@
@@@@...@@@@@@@@.....@..@@@........@@@..@@..@@@@@@@....@..@@@@@........@..@@@@@...@@@@@@@@@@.@@@@@@@..@@@...@@@..@..@@@@@@@@@....@.....@@.....@.......@@...@@@@@@
@@........@@@@.........@@@....@@@@@@@..@@@.......@..@@@@@@@@@@@......@@..@@.@@@@@@@@@@@@@@@...@@@@@@.....@@@@@......@@@@@@@@@@..@@..@@@..@@.........@@@..@@@@@@@
@...@@@....@@@...@......@......@@@@@@.@@@@@@@@....@@@@@@@@@@@@@................@@@@@@@@@@@..@...@.@.....@@@@@.......@@@@@..@@@..@@@.@@..@@@.........@@@..@@@@@@@
@..@@@@@@..@@...@@.........@@...@@@@@.@@@@@@@@@@..@@@@@@@@@.@@@..@@@..@@..@@...@@@@.......@@@@.........@@@@@..@.....@@@@....@@@..@@@..@@@@.......@@@@@@..@@@@@@@
@...@@@@@..@@...@@@.@.......@@...@@@......@@@@@@@@@@@@@@@@.......@@..@@@@...@@@.@@..@@@...@@@@.........@@@@@........@@@..@@..@@@.@@@@@@@@..@@....@...@@@..@@@@@@
@..@..@@@..@@.@@@@@@@.......@@@..@@@....@@@@@@@@@@@@@@@@..@@@....@@..@@@@.......@..@@@@@@.@@@@@@@@........@@.......@@@@.@@@@.@...@@@@@@..@@@@..@@@.....@.@@@@@@@
@@@@..@@@@.@@.@@@@@@@@.....@@@...@@....@@.@@@@@@@@@@@@@@..@@@........@@@........@.@@@@@@..@@@@@@@@@@......@.......@@@@.@@@@@....@@@@.........@@@@@@@@....@@@@@@@
@@@@...@@@...@@@@@@@@@....@.....@........@@@@@@@@@@@.....@@@....@@@.......@....@@@.....@..@@@@@@@@@@@@.................@@@@...@@@@@@......@@@@@@@@@@@@@@@@@@@@@@
@.......@@.@@@@@@@@@@@@.@@@....@@........@@@@..@@@.....@@@.....@@@@@.@....@@@@.@@@.......@@@@@@@@@@@@@...@@@.@@@..@@@@@@@@....@@@@@@@..@@@@@@@@@@@@@@@@@@@@@@..@
@..@...@...@@@@@@@@@@@@.@......@@@.......@@@.@@.....@@@@@.......@@@@.@@........@@@...@@@@..@@.@@.....@..@@@@....@@@@@@@@@@@@@..@@@@@@@@@@@@@@@@@@@@@@@@@.......@
@.@@@........@@@@@@@@@@........@@@@@@@@...@................@...@.@@@.@@@.........@@.@@@@@..........@...@@@@@....@@@@@@@@@@......@@@@@@@@@@@....@@@@@@@....@@@..@
@.@@@@....@@..@@@..@@@@.........@@@@@@@@.........@@.......@...@@.....@@@@........@@.@@@@@.@@@....@@@...@@@@@...@@@@@@@@@........@@@@@@@@@@..@......@@@.@@@@....@
@..@@@...@@@@@......@@@..@........@@@@@@@@@.....@@...........@@@@....@@@@@@@........@@@@..@@@@@@@@@@...@@@@@@.@@@@@@@@........@.@@@@@@@@@@..@@..@@...@.........@
@@....@@@@@@@@@....@@@@..@...........@@@@@@@@@@@@...........@@@.....@@@..@@@@@@......@@@@......@@@@.....@@@@..........@@..@.....@@@@@@@@@@@...@@@@.............@
@@@....@@@@@@@@.....@@@.@@....@........@@@@@@@@@............@@....@@@.....@@@@@...@@@@@.........@@@...@.@@@@..........@@@@@......@@@@@@@@@@@...@@.....@@@@.....@
@@@@...@@@@@@@......@@@.@@................@@@@@...@........@@.....@@.......@@@@...@@@@...........@@......@@....@@@@....@@@@..@@.....@@@@@@@@@@..@...@.@@@@@....@
@@@@...@@@@@@@.....@@@@..@.@@@..@@@@@......@@@..@@@.......@@..@@..@@.......@@@@@...@@@......@@...@@...@......@@@@...@@..@@@..@@@..@..@@@@@@@@@..@.....@@@@@....@
@@@...@@@...@....@.@@@@@@@@@@@@..@@@..@@@.....@@@@....@@@@@@..@@..@@...@....@@@@..@@@...@........@@..@@...@@@@@@@..@@@....@.@@@@.@@@..@@@@@@@@..@@...@@@@@@@@..@
@@....@@........@@..@@@@@@@@@@@@........@@@@@@@@@@..@@@@@@@..@@@..@@.........@@@@.@@@...@.......@@...@@..@@@@@@@..@@@@@....@@@@@.@@@@.@@@@@@@..@@@@..@@@@@@@...@
@..@@.......@@..@.......@@@@@@@@.........@@@@@@@@@.@@@@@@@@..@@@..@@@.........@@@..@@@.@@@.....@@....@...@@@@@@..@@@@@@....@@@@@..@@@.@@@@@@..@@@@@@.@@@@@@@...@
@@@@@@@@@@@@@@......@@@...@@@@@@.......@.@@@@@@@@@.@@@@@@@@..@@..@@@@@........@@@......@@@@...@@@........@@......@@@@@.@.....@@@@..@@..@@@@.....@@@@..@@@@@@..@@
@@@@@@@@@@@@@@.....@@@@@...@@@..@...@@@@.......@@@..@@....@@....@@@@@@@@@@@.....@@...........@@@@...@....@......@@@@@..@@.....@@@@..@.@@@@@.@....@@@..@@@@@@.@@@
@@@@@@@@@..@@@@@...@@@@@@...@@..@@@@@@@........@@@@........@@..@@@@@@@....@@.....@@@@.............@@@@@@....................@..@@@@@@@@@@@..@....@@@.@@@@@@@...@
@@@....@...@@@@@@..@@@@.....@@@.@@@@@@...@@@.@@@@@@@@..@...@@@@@@@@@@...............@@@..........@@@@@@@.......@@@...........@.@@@@@...@@@...@@..@@@.@@@@@@....@
@@@@.@.@@...@@@@@..@@@@...@.@@@.@@......@@@@@@@@..@@@@@@...@@@@@@@@@.........@@@@@@@@@@@..........@@@@@@...@@@@.....@@@@@@......@@@@.....@@.@@@..@@@..@@@@.....@
@..@@@@@@@.@@@@@@..@@@@...@.@@......@...@@@@@@@.@@.@@@@@..@@@@@@@@@@...@@...@@@@@@@@@@@@..@@......@@@@@.....@@.......@@@@@@...........@@..@@@@@@..@@..@@@......@
@..@@@@@@@@@@@@@..@@@@@@@@@.@......@@@.@.@@@@@@@...@@@@...@@@@@@@@@@.........@@@@@@@@@@@...@@@@@@@.@@@@@@@............@@@@.@...@...@@.....@@@@@@@.....@@..@@@..@
@...@@@@@@@@@@..@@@@@@@@@@..@@.@..@@@@.@..@@@@@@....@.......@@@@@@@@@..........@@@@@@@@@@...@@@@@..@@@.@@@@@@@..@..........@...@@@@@.......@@@@@@..............@
@.........@@@@.@@@@.....@...@..@..@@@@.@...@..@@@.......@....@@@@@@@@@....@@@...@@.....@@@@..@@@@..@@@@..@@@@@@..@@@@@@........@@@..........@@@@@@@@...........@
@......@@..@@@.@@@.........@@..@...@@@@@@@....@@@.@@@@@@......@@@@@@@@@@...@@@..........@@@..@@@@.@@@@@.@@@@@@@..@@@@@@@.......@....@@@....@@@@@@@@@@@.........@
@@.@..@@@@.@@@.@@@...@@.@@@@...@@...@@@@@@....@@..@@@@@@......@@@@@@@@@@.....@...@@@@@@..@@..@@@@..@@@@@@@@@@@@...@@@@@@............@@@....@@@@@@@@@@.@@...@@..@
@@@@.@@@@..@@..@@@@..@@@@@@@@...@@...@@@@@.....@..@@@@@.......@@@@@@@@@@.....@@@@@@@@@@..@@..@@@@..@@@@@@@@@@@@....@@@@.....@@.....@@@@....@@@@@@@@@..@@..@@...@
@..@...@@..@@...@@@...@@@@@@....@@@@@..........@....@@@...@...@@@@@@.........@@@@@@@@@@..@@.@@@@@@..@@@@@@@@@@.@...@@@.....@@@....@.@@@....@@@@@@@@@.....@@@...@
@........@@@@............@.....@@@@@@@....@@@...@@........@@..@@@@@.........@@@@..@@@@@...@.@@@@@@@..@@@@@@@@@.@....@@......@@@...@..@@..@.@@@@@........@@@@..@@
@..@....@@@@.@@@@.............@@@@@@@@@@@@@@@@@.@@@......@@@@.@@@@.......@@@@@.....@@@@@.....@@@@@@@..@@@@@@@@......@@......@@@@.....@@@.@..@@@..@...@@@@@@@.@@@
@.......@@@@..@@@@........@@@@@@@@@@@@@@@@@@@@@..@@..@@@.@....@@@@........@@........@@@@@.....@@@@@@@.@@@@@@@...@@..@@......@@@@.....@@@.@@.....@@..@@@@@@@@...@
@.......@@@@...@@@...@@@@@@...@@@@@@@@@..@@@@@@....@@@@@.......@@@...@....@..........@@@@@.@@..@@@@@@.@@@@......@@@.@@......@@@@@.....@...@@..@@@@..@@@@@@@@@..@
@.......@@@@@.@@@...@@@@@@......@@@@@.....@@@@@......@@@..@.....@....@@...@.....@.....@@@@.@@..@@@@@..@@@.@@@@@..@@.@@......@@@@@@...@@@..@@@....@@...@@@@@@@@@@
@@@@...@.@@@.@@@...@@@@@@...@@...@@@......@@@@@......@@@..@@@...@....@.@@@@@..@@@@.@......@@@..@@@@..@@@@.@@@@@@.@@.@@...@...@@@@@...@@@@..@......@@......@.@@@@
@@@@......@@.@@..@@@@@@@@..@@@@..@@@.....@@@@@@@......@@..@@@...@......@@@@@@.@@@..@..........@@@@..@@@@@..@@@@@.@@..@..@@...@@@@...@@@@......@...@@@@@..@@..@@@
@@@@..@............@@@@@..@@@@@..@@@.....@...@@@@@@@@....@@@....@@....@@@@@@...@..@@.........@@@@@.@@@@@@....@@..@@@...@@@...@@@..............@@...@@@@@@@@..@@@
@@....@..@@...............@@@@@@.@@@@.........@@@@......@@......@@@..............@@@.@@@....@@..@@.@@@@@@@.......@@@@@@@@@...@@...........@.........@@@@@@@@.@@@
@........@@...@@...@@.....@@@@@@..@@@@........@@.....@@.@......@@@@@.....@..@@@@@@@@.@@@@@@@.......@@@@@@@@@.....@@@@@@@@@..@@@.....@@@@@@@....@.....@@@@@@@.@@@
@........@@@@@@@...@@@...@.@@@@@...@@@....@...@......@@.......@@@@@@@@@@@@..@@@@@@@@..@@@@@.....@.@@@@...@@@.....@@@@@@.@@..@@@.........@@@....@@.....@@@@@.@@@@
@.......@@@@@@@@@...@@..@@.@@@......@@@...@...@.....@@@....@.@@@@@@@........@@@@@@@@@.@@@.....@...@...@...@@@....@@@@@......@@@@...@@@...@@....@@@.....@@@..@@@@
@..@....@@@@@@@@@@.....@@@.@@@.@@....@@...@...@...@@@@@....@.@@@@...........@@@@@@@@@.........@.......@@@..@@..@..@@@..@.....@@@@..@@@@@@..@...@@@@....@@..@@@@@
@@@@...@@@.......@@....@@..@@.@@@@......@@@@..@@....@@@.@..@@.........@@....@@@@@@.........@@....@@...@@@..@@@.@...@@..@@.....@@@...@@@@@@@@..@@@@@@....@..@@@@@
@......@@...............@..@@.@@@@@....@@@@@.@@@@.....@.@.@@@......@@@@@@.@..@@@@......@@@@......@@....@@@.....@@@.....@@@....@@@...@@@@@@@...@@@@@@.@....@@@@.@
@..@...@@...@@@@...@@@@....@@@.@@@@@..@@@@@@.@@@@@........@@@@.....@@@@@@....@@@@@..@.@@@@@..@@....@@...@@@....@@@@@...@@@.....@......@@@@...@@@@@...@@@@@@@@..@
@@.@@..@..@@@@@@...@@@@..@.@@@..@@@@.@@@@@@@.@@@..........@@@@..@...@@@@@.....@@@@.@@.@@@@@@@@@...@@@@..@@@@..@@@@@@....@@..................@@@......@@@@@@@@.@@
@@@@@.....@@@@@@...@@@@.@@@.@@@@.....@@@@@@@........@@....@@@@..@@..@@@@.....@.@@@.@...@@@@@@.....@@@@..@@@@@@@@@@...@@..@@....@@@.........@@@......@@@@@@@@.@@@
@@@@@.@.@@@@@@@..@..@@@.@@@..@@@@@@@..@@@@@@@........@@@@..@@...@@@.......@@@@..@@......@@@@...@...@@...@....@@@@....@@@..@@.@@@@@.........@@@.....@@@@@@@@@.@@@
@@@@@..@@@@@@@@@.@..@@@.@@@@..@@@@@@@.@@@@@@@@@.@@....@@@@.....@@@@@...@@@@@@@..@@@....@..@@@@@@@......@......@@@...@@@@@....@@@@@....@@@@@@@@.......@@@@@@@..@@
@@@@@@@@..@@@@@@.@..@@..@@@@@..@@@@@@@....@@@@@@@.............@@@@@...@@@@@@@...@@@@@@................@@.......@@....@..@.....@@@.@@@@@@@@@@@@@......@@@@@@@..@@
@@.@@@@@.....@@@@...@@...@@@@@.@@@@@@@.......@@@@...@@.....@@@@@@@.....@@@@@@.....@@@@@..............@@...@@....@@............@@....@@@@@@@@@@@@@@.....@@@@@@.@@
@@@@@@@@.@@@..@@@@@.............@@@@@@@..@@..@@@@@@@@@@@@..@@@@@@@......@@@@@.....@@@@@...@........@@@@..@@......@@.....@@@@@........@@@@@@@@@@@@@@@@...@@@@...@
@@@@@@@@..@@@@..@@@..@@..@@@@.......@@@..@@@..@@@@@@@@@@@..@@@@@@.......@@@@..@@..@@@@@@..@@@@@.....@@@..@.......@@.............@.....@@@@@@@....@@@@@.........@
@@@@@@@@@..@@@@.@@@..@@.@@@@@@@@...@@@@..@@@@...@@@@@@@@@..@@@@@........@@@@...@...@@@@.......@@...............@..@@............@@....@@@@@@......@@@@@...@@...@
@@@@@@@@@..@@@@.@@@..@@..@@@@@@@...@@@@..@@@@@@@@@@@@@@@@@.@@@@@....@...@@@@.......@@@.@.......@@@....@@@.@@@..@@....@@...............@@@@@.......@@@@@@.@@@@..@
@@@@@@@@@@.@@@..@@..@@...@@@@@@....@@@@..@@@@...@@@@...@@@.@@@@........@@@@@@......@@@.@@......@@@@...@@@.@@@@.@@@...@@@.@...@...........@@.......@@@@@...@@@@@@
@@....@@@..@@......@@....@@@@@@...@@@@..@@@....@@@@@.@.....@@@.........@@@@@@@@@@@.@@@..@@......@@@@..@@@..@@@..@@@.@@@@.....@@...........@.......@@@......@@@@@
@...@.@@@..@@...@..@......@@@@.........@@@..@@@@@@@..@@....@@.........@@@@@@@@@@@@..@....@@@@....@@@@..@@..@@@...@@.@@.@....@@@@@@@@......@............@@@..@@@@
@....@@@@@........@@......@@@..@@@....@@@..@@@@@@@@@.@@....@....@....@@@@@@@@@@@@.........@@@.....@@@@.@@..@@@..............@@@@@@@@..@...@.........@@@@@@...@@@
@...@@@@@@@.......@....@@.@@@.@@@@@@@@@@@..@@@@@@@@@.@@...@@...@@....@@@@..@@@@@@....@....@@@@.....@@..@@@..@@..........@...@@....@@......@......@@@@@@..@@....@
@.@@@@@@@@@@@@@.......@@@.@@@.@@@@@@@@@@@.@@@@@..@@@@.....@@...@@...@@@@......@@.....@@...@@@@@@@@@..@@@@@.........@@...@...@.......@@@..@@.......@......@@@@..@
@@@@@@@@@@@@@@@@@@...@@@@.@@@.@@@...@@@@@.@@@@.@..@@@@@..@@@...@@...@@...@@@...@....@@@....@@@..@@@@@@@@@@@@@@@..@@@@..@@@.@.........@@.@@@...........@@@.@@@@@@
@@@@...@@@@..@@@@@...@@@..@@..@@.....@@@@..@@@..@.@@@@...@@@............@@@@...@....@@@@....@@..@@@@@@..@..@@@@..@@@@..@@@@....@@....@...@.........@@@@@...@@@@@
@@...@..@@.@@.@@@@@..@@@..@@..@@.....@@@@..@@@..@..@@@@..@@@............@@@@@..@...@@@@@....@@..@@@@@@.@@..@@@@..@@@@..@@@@...@@@@@..@...@........@@@@@@..@@@@@@
@@@@@@@@@@@@@@@@@@@@@@@@@@@@@@@@@@@@@@@@@@@@@@@@@@@@@@@@@@@@@@@@@@@@@@@@@@@@@@@@@@@@@@@@@@@@@@@@@@@@@@@@@@@@@@@@@@@@@@@@@@@@@@@@@@@@@@@@@@@@@@@@@@@@@@@@@@@@@@@@
